S.....#.
.###..#.
..#...#.
.#.#..#.
...#G.#.
