S.#.....
.####...
....#.#.
##......
.....#..
..#.#..#
.....#..
G.#.....